11111111111111111111111111111111111
1E100000000000000000000010100000111
1CC00101001000001010010001111111011
1C000100101010100010010001000001011
1000000000000P000000000000111110011
11111111111111111111111111111111111



